Sample_ID	Sample_illustration
22RV1_PROSTATE	Prostate carcinoma
2313287_STOMACH	Stomach carcinoma
253JBV_URINARY_TRACT	Urinary_tract carcinoma
253J_URINARY_TRACT	Urinary_tract carcinoma
42MGBA_CENTRAL_NERVOUS_SYSTEM	Central_nervous_system glioma
5637_URINARY_TRACT	Urinary_tract carcinoma
59M_OVARY	Ovary carcinoma
639V_URINARY_TRACT	Urinary_tract carcinoma
647V_URINARY_TRACT	Urinary_tract carcinoma
697_HAEMATOPOIETIC_AND_LYMPHOID_TISSUE	Haematopoietic_and_lymphoid_tissue
769P_KIDNEY	Kidney carcinoma
786O_KIDNEY	Kidney carcinoma
8305C_THYROID	Thyroid carcinoma
8505C_THYROID	Thyroid carcinoma
8MGBA_CENTRAL_NERVOUS_SYSTEM	Central_nervous_system glioma
A101D_SKIN	Skin malignant_melanoma
A1207_CENTRAL_NERVOUS_SYSTEM	Central_nervous_system glioma
A172_CENTRAL_NERVOUS_SYSTEM	Central_nervous_system glioma
A204_SOFT_TISSUE	Soft_tissue
A2058_SKIN	Skin malignant_melanoma
A253_SALIVARY_GLAND	Salivary_gland carcinoma
A2780_OVARY	Ovary carcinoma
A375_SKIN	Skin malignant_melanoma
A3KAW_HAEMATOPOIETIC_AND_LYMPHOID_TISSUE	Haematopoietic_and_lymphoid_tissue
A427_LUNG	NA NA
A498_KIDNEY	Kidney carcinoma
A4FUK_HAEMATOPOIETIC_AND_LYMPHOID_TISSUE	Haematopoietic_and_lymphoid_tissue
A549_LUNG	Lung carcinoma
A673_BONE	Bone Ewings_sarcoma-peripheral_primitive_neuroectodermal_tumour
A704_KIDNEY	Kidney carcinoma
ABC1_LUNG	Lung carcinoma
ACCMESO1_PLEURA	Pleura mesothelioma
ACHN_KIDNEY	Kidney carcinoma
AGS_STOMACH	Stomach carcinoma
ALLSIL_HAEMATOPOIETIC_AND_LYMPHOID_TISSUE	Haematopoietic_and_lymphoid_tissue
AM38_CENTRAL_NERVOUS_SYSTEM	Central_nervous_system glioma
AML193_HAEMATOPOIETIC_AND_LYMPHOID_TISSUE	Haematopoietic_and_lymphoid_tissue
AMO1_HAEMATOPOIETIC_AND_LYMPHOID_TISSUE	Haematopoietic_and_lymphoid_tissue
AN3CA_ENDOMETRIUM	Endometrium carcinoma
ASPC1_PANCREAS	Pancreas carcinoma
AU565_BREAST	Breast carcinoma
BC3C_URINARY_TRACT	Urinary_tract carcinoma
BCP1_HAEMATOPOIETIC_AND_LYMPHOID_TISSUE	Haematopoietic_and_lymphoid_tissue
BCPAP_THYROID	Thyroid carcinoma
BDCM_HAEMATOPOIETIC_AND_LYMPHOID_TISSUE	Haematopoietic_and_lymphoid_tissue
BEN_LUNG	Lung carcinoma
BFTC905_URINARY_TRACT	Urinary_tract carcinoma
BFTC909_KIDNEY	Kidney carcinoma
BHT101_THYROID	Thyroid carcinoma
BHY_UPPER_AERODIGESTIVE_TRACT	Upper_aerodigestive_tract carcinoma
BICR16_UPPER_AERODIGESTIVE_TRACT	Upper_aerodigestive_tract carcinoma
BICR18_UPPER_AERODIGESTIVE_TRACT	Upper_aerodigestive_tract carcinoma
BICR22_UPPER_AERODIGESTIVE_TRACT	Upper_aerodigestive_tract carcinoma
BICR31_UPPER_AERODIGESTIVE_TRACT	Upper_aerodigestive_tract carcinoma
BICR56_UPPER_AERODIGESTIVE_TRACT	Upper_aerodigestive_tract carcinoma
BICR6_UPPER_AERODIGESTIVE_TRACT	Upper_aerodigestive_tract carcinoma
BL41_HAEMATOPOIETIC_AND_LYMPHOID_TISSUE	Haematopoietic_and_lymphoid_tissue
BL70_HAEMATOPOIETIC_AND_LYMPHOID_TISSUE	Haematopoietic_and_lymphoid_tissue
BT12_SOFT_TISSUE	NA NA
BT20_BREAST	Breast carcinoma
BT474_BREAST	Breast carcinoma
BT483_BREAST	Breast carcinoma
BT549_BREAST	Breast carcinoma
BV173_HAEMATOPOIETIC_AND_LYMPHOID_TISSUE	Haematopoietic_and_lymphoid_tissue
BXPC3_PANCREAS	Pancreas carcinoma
C2BBE1_LARGE_INTESTINE	Large_intestine carcinoma
C32_SKIN	Skin malignant_melanoma
C8166_HAEMATOPOIETIC_AND_LYMPHOID_TISSUE	NA NA
CA46_HAEMATOPOIETIC_AND_LYMPHOID_TISSUE	Haematopoietic_and_lymphoid_tissue
CACO2_LARGE_INTESTINE	NA NA
CADOES1_BONE	Bone Ewings_sarcoma-peripheral_primitive_neuroectodermal_tumour
CAKI1_KIDNEY	Kidney carcinoma
CAKI2_KIDNEY	Kidney carcinoma
CAL120_BREAST	Breast carcinoma
CAL12T_LUNG	Lung carcinoma
CAL148_BREAST	Breast carcinoma
CAL27_UPPER_AERODIGESTIVE_TRACT	Upper_aerodigestive_tract carcinoma
CAL29_URINARY_TRACT	Urinary_tract carcinoma
CAL33_UPPER_AERODIGESTIVE_TRACT	Upper_aerodigestive_tract carcinoma
CAL51_BREAST	Breast carcinoma
CAL54_KIDNEY	Kidney carcinoma
CAL62_THYROID	Thyroid carcinoma
CAL78_BONE	Bone chondrosarcoma
CAL851_BREAST	Breast carcinoma
CALU1_LUNG	Lung carcinoma
CALU3_LUNG	Lung carcinoma
CALU6_LUNG	Lung carcinoma
CAMA1_BREAST	Breast carcinoma
CAOV3_OVARY	Ovary carcinoma
CAOV4_OVARY	Ovary carcinoma
CAPAN1_PANCREAS	Pancreas carcinoma
CAPAN2_PANCREAS	Pancreas carcinoma
CAS1_CENTRAL_NERVOUS_SYSTEM	Central_nervous_system glioma
CCFSTTG1_CENTRAL_NERVOUS_SYSTEM	Central_nervous_system glioma
CCK81_LARGE_INTESTINE	Large_intestine carcinoma
CFPAC1_PANCREAS	Pancreas carcinoma
CH157MN_CENTRAL_NERVOUS_SYSTEM	Central_nervous_system meningioma
CHAGOK1_LUNG	Lung carcinoma
CHP126_AUTONOMIC_GANGLIA	Autonomic_ganglia neuroblastoma
CHP212_AUTONOMIC_GANGLIA	Autonomic_ganglia neuroblastoma
CI1_HAEMATOPOIETIC_AND_LYMPHOID_TISSUE	Haematopoietic_and_lymphoid_tissue
CJM_SKIN	Skin malignant_melanoma
CL11_LARGE_INTESTINE	Large_intestine carcinoma
CL14_LARGE_INTESTINE	Large_intestine carcinoma
CL34_LARGE_INTESTINE	Large_intestine carcinoma
CL40_LARGE_INTESTINE	Large_intestine carcinoma
CMK_HAEMATOPOIETIC_AND_LYMPHOID_TISSUE	Haematopoietic_and_lymphoid_tissue
CMLT1_HAEMATOPOIETIC_AND_LYMPHOID_TISSUE	Haematopoietic_and_lymphoid_tissue
COLO201_LARGE_INTESTINE	Large_intestine carcinoma
COLO320_LARGE_INTESTINE	Large_intestine carcinoma
COLO668_LUNG	Lung carcinoma
COLO678_LARGE_INTESTINE	Large_intestine carcinoma
COLO679_SKIN	Skin malignant_melanoma
COLO680N_OESOPHAGUS	Oesophagus carcinoma
COLO684_ENDOMETRIUM	Endometrium carcinoma
COLO741_SKIN	Skin malignant_melanoma
COLO783_SKIN	Skin malignant_melanoma
COLO792_SKIN	Skin malignant_melanoma
COLO800_SKIN	Skin malignant_melanoma
COLO829_SKIN	Skin malignant_melanoma
CORL105_LUNG	Lung carcinoma
CORL23_LUNG	Lung carcinoma
CORL24_LUNG	Lung carcinoma
CORL279_LUNG	Lung carcinoma
CORL311_LUNG	Lung carcinoma
CORL47_LUNG	Lung carcinoma
CORL88_LUNG	Lung carcinoma
CORL95_LUNG	Lung carcinoma
COV318_OVARY	Ovary carcinoma
COV362_OVARY	Ovary carcinoma
COV434_OVARY	Ovary sex_cord-stromal_tumour
COV644_OVARY	Ovary carcinoma
CW2_LARGE_INTESTINE	Large_intestine carcinoma
D283MED_CENTRAL_NERVOUS_SYSTEM	Central_nervous_system primitive_neuroectodermal_tumour-medulloblastoma
D341MED_CENTRAL_NERVOUS_SYSTEM	Central_nervous_system primitive_neuroectodermal_tumour-medulloblastoma
DANG_PANCREAS	Pancreas carcinoma
DAOY_CENTRAL_NERVOUS_SYSTEM	Central_nervous_system primitive_neuroectodermal_tumour-medulloblastoma
DAUDI_HAEMATOPOIETIC_AND_LYMPHOID_TISSUE	Haematopoietic_and_lymphoid_tissue
DBTRG05MG_CENTRAL_NERVOUS_SYSTEM	Central_nervous_system glioma
DB_HAEMATOPOIETIC_AND_LYMPHOID_TISSUE	Haematopoietic_and_lymphoid_tissue
DEL_HAEMATOPOIETIC_AND_LYMPHOID_TISSUE	Haematopoietic_and_lymphoid_tissue
DETROIT562_UPPER_AERODIGESTIVE_TRACT	Upper_aerodigestive_tract carcinoma
DKMG_CENTRAL_NERVOUS_SYSTEM	Central_nervous_system glioma
DM3_FIBROBLAST	Pleura mesothelioma
DMS114_LUNG	Lung carcinoma
DMS153_LUNG	Lung carcinoma
DMS273_LUNG	Lung carcinoma
DMS454_LUNG	Lung carcinoma
DMS53_LUNG	Lung carcinoma
DMS79_LUNG	Lung carcinoma
DND41_HAEMATOPOIETIC_AND_LYMPHOID_TISSUE	Haematopoietic_and_lymphoid_tissue
DOHH2_HAEMATOPOIETIC_AND_LYMPHOID_TISSUE	Haematopoietic_and_lymphoid_tissue
DU145_PROSTATE	Prostate carcinoma
DU4475_BREAST	Breast carcinoma
DV90_LUNG	Lung carcinoma
EB1_HAEMATOPOIETIC_AND_LYMPHOID_TISSUE	Haematopoietic_and_lymphoid_tissue
EBC1_LUNG	Lung carcinoma
ECC10_STOMACH	Stomach carcinoma
ECC12_STOMACH	Stomach carcinoma
ECGI10_OESOPHAGUS	Oesophagus carcinoma
EFE184_ENDOMETRIUM	Endometrium carcinoma
EFM192A_BREAST	Breast carcinoma
EFM19_BREAST	Breast carcinoma
EFO21_OVARY	Ovary carcinoma
EFO27_OVARY	Ovary carcinoma
EHEB_HAEMATOPOIETIC_AND_LYMPHOID_TISSUE	Haematopoietic_and_lymphoid_tissue
EJM_HAEMATOPOIETIC_AND_LYMPHOID_TISSUE	Haematopoietic_and_lymphoid_tissue
EKVX_LUNG	Lung carcinoma
EM2_HAEMATOPOIETIC_AND_LYMPHOID_TISSUE	Haematopoietic_and_lymphoid_tissue
EN_ENDOMETRIUM	Endometrium carcinoma
EOL1_HAEMATOPOIETIC_AND_LYMPHOID_TISSUE	Haematopoietic_and_lymphoid_tissue
EPLC272H_LUNG	Lung carcinoma
ES2_OVARY	Ovary carcinoma
ESS1_ENDOMETRIUM	Endometrium carcinoma
EW8_BONE	Bone Ewings_sarcoma-peripheral_primitive_neuroectodermal_tumour
EWS502_BONE	Bone Ewings_sarcoma-peripheral_primitive_neuroectodermal_tumour
F36P_HAEMATOPOIETIC_AND_LYMPHOID_TISSUE	Haematopoietic_and_lymphoid_tissue
FADU_UPPER_AERODIGESTIVE_TRACT	Upper_aerodigestive_tract carcinoma
FTC133_THYROID	Thyroid carcinoma
FTC238_THYROID	Thyroid carcinoma
FU97_STOMACH	Stomach carcinoma
FUOV1_OVARY	Ovary carcinoma
G292CLONEA141B1_BONE	Bone osteosarcoma
G361_SKIN	Skin malignant_melanoma
G401_SOFT_TISSUE	Soft_tissue
G402_SOFT_TISSUE	Soft_tissue
GA10_HAEMATOPOIETIC_AND_LYMPHOID_TISSUE	Haematopoietic_and_lymphoid_tissue
GAMG_CENTRAL_NERVOUS_SYSTEM	Central_nervous_system glioma
GB1_CENTRAL_NERVOUS_SYSTEM	Central_nervous_system glioma
GCIY_STOMACH	Stomach carcinoma
GCT_SOFT_TISSUE	Soft_tissue
GDM1_HAEMATOPOIETIC_AND_LYMPHOID_TISSUE	Haematopoietic_and_lymphoid_tissue
GI1_CENTRAL_NERVOUS_SYSTEM	Central_nervous_system glioma
GMS10_CENTRAL_NERVOUS_SYSTEM	Central_nervous_system glioma
GOS3_CENTRAL_NERVOUS_SYSTEM	Central_nervous_system glioma
GP2D_LARGE_INTESTINE	Large_intestine carcinoma
GRANTA519_HAEMATOPOIETIC_AND_LYMPHOID_TISSUE	Haematopoietic_and_lymphoid_tissue
GSS_STOMACH	Stomach carcinoma
GSU_STOMACH	Stomach carcinoma
H4_CENTRAL_NERVOUS_SYSTEM	Central_nervous_system glioma
HARA_LUNG	Lung carcinoma
HCC1143_BREAST	Breast carcinoma
HCC1171_LUNG	Lung carcinoma
HCC1187_BREAST	Breast carcinoma
HCC1195_LUNG	Lung carcinoma
HCC1359_LUNG	Lung carcinoma
HCC1395_BREAST	Breast carcinoma
HCC1419_BREAST	Breast carcinoma
HCC1428_BREAST	Breast carcinoma
HCC1438_LUNG	Lung carcinoma
HCC1500_BREAST	Breast carcinoma
HCC1569_BREAST	Breast carcinoma
HCC1588_LUNG	Lung carcinoma
HCC1599_BREAST	Breast carcinoma
HCC15_LUNG	Lung carcinoma
HCC1806_BREAST	Breast carcinoma
HCC1833_LUNG	Lung carcinoma
HCC1937_BREAST	Breast carcinoma
HCC1954_BREAST	Breast carcinoma
HCC202_BREAST	Breast carcinoma
HCC2108_LUNG	Lung carcinoma
HCC2157_BREAST	Breast carcinoma
HCC2218_BREAST	Breast carcinoma
HCC2279_LUNG	Lung carcinoma
HCC2429_LUNG	NA NA
HCC2450_LUNG	NA NA
HCC2814_LUNG	Lung carcinoma
HCC2935_LUNG	Lung carcinoma
HCC33_LUNG	Lung carcinoma
HCC364_LUNG	Lung carcinoma
HCC366_LUNG	Lung carcinoma
HCC38_BREAST	Breast carcinoma
HCC4006_LUNG	Lung carcinoma
HCC44_LUNG	Lung carcinoma
HCC461_LUNG	NA NA
HCC515_LUNG	NA NA
HCC56_LARGE_INTESTINE	Large_intestine carcinoma
HCC70_BREAST	Breast carcinoma
HCC78_LUNG	Lung carcinoma
HCC827GR5_LUNG	Lung carcinoma
HCC827_LUNG	Lung carcinoma
HCC95_LUNG	Lung carcinoma
HCT116_LARGE_INTESTINE	Large_intestine carcinoma
HCT15_LARGE_INTESTINE	Large_intestine carcinoma
HDLM2_HAEMATOPOIETIC_AND_LYMPHOID_TISSUE	Haematopoietic_and_lymphoid_tissue
HDMYZ_HAEMATOPOIETIC_AND_LYMPHOID_TISSUE	Haematopoietic_and_lymphoid_tissue
HDQP1_BREAST	Breast carcinoma
HEC108_ENDOMETRIUM	Endometrium carcinoma
HEC151_ENDOMETRIUM	Endometrium carcinoma
HEC1A_ENDOMETRIUM	Endometrium carcinoma
HEC1B_ENDOMETRIUM	Endometrium carcinoma
HEC251_ENDOMETRIUM	Endometrium carcinoma
HEC265_ENDOMETRIUM	Endometrium carcinoma
HEC50B_ENDOMETRIUM	Endometrium carcinoma
HEC59_ENDOMETRIUM	Endometrium carcinoma
HEC6_ENDOMETRIUM	Endometrium carcinoma
HEKTE_KIDNEY	Kidney other
HEL9217_HAEMATOPOIETIC_AND_LYMPHOID_TISSUE	Haematopoietic_and_lymphoid_tissue
HELA_CERVIX	NA NA
HEL_HAEMATOPOIETIC_AND_LYMPHOID_TISSUE	Haematopoietic_and_lymphoid_tissue
HEP3B217_LIVER	Liver carcinoma
HEPG2_LIVER	Liver carcinoma
HEYA8_OVARY	Ovary carcinoma
HGC27_STOMACH	Stomach carcinoma
HH_HAEMATOPOIETIC_AND_LYMPHOID_TISSUE	Haematopoietic_and_lymphoid_tissue
HL60_HAEMATOPOIETIC_AND_LYMPHOID_TISSUE	Haematopoietic_and_lymphoid_tissue
HLFA_FIBROBLAST	Lung carcinoma
HLF_LIVER	Liver carcinoma
HMC18_BREAST	Breast carcinoma
HMCB_SKIN	Skin malignant_melanoma
HMEL_BREAST	Breast other
HNT34_HAEMATOPOIETIC_AND_LYMPHOID_TISSUE	NA NA
HOP62_LUNG	Lung carcinoma
HOP92_LUNG	Lung carcinoma
HOS_BONE	Bone osteosarcoma
HPAC_PANCREAS	Pancreas carcinoma
HPAFII_PANCREAS	Pancreas carcinoma
HPBALL_HAEMATOPOIETIC_AND_LYMPHOID_TISSUE	Haematopoietic_and_lymphoid_tissue
HS172T_FIBROBLAST	Urinary_tract carcinoma
HS229T_FIBROBLAST	Lung carcinoma
HS255T_FIBROBLAST	Large_intestine carcinoma
HS274T_FIBROBLAST	Breast carcinoma
HS281T_FIBROBLAST	Breast carcinoma
HS294T_SKIN	Skin malignant_melanoma
HS343T_FIBROBLAST	Breast carcinoma
HS578T_BREAST	Breast carcinoma
HS600T_FIBROBLAST	Skin malignant_melanoma
HS606T_FIBROBLAST	Breast carcinoma
HS611T_HAEMATOPOIETIC_AND_LYMPHOID_TISSUE	Haematopoietic_and_lymphoid_tissue
HS616T_FIBROBLAST	Haematopoietic_and_lymphoid_tissue
HS618T_FIBROBLAST	Lung carcinoma
HS675T_FIBROBLAST	Large_intestine carcinoma
HS683_CENTRAL_NERVOUS_SYSTEM	Central_nervous_system glioma
HS688AT_FIBROBLAST	Skin malignant_melanoma
HS695T_SKIN	Skin malignant_melanoma
HS698T_FIBROBLAST	Large_intestine carcinoma
HS706T_BONE	Bone giant_cell_tumour
HS729_SOFT_TISSUE	Soft_tissue
HS737T_FIBROBLAST	Bone giant_cell_tumour
HS739T_FIBROBLAST	Breast carcinoma
HS742T_FIBROBLAST	Breast carcinoma
HS746T_STOMACH	Stomach carcinoma
HS751T_FIBROBLAST	Haematopoietic_and_lymphoid_tissue
HS766T_PANCREAS	Pancreas carcinoma
HS819T_FIBROBLAST	Bone chondrosarcoma
HS821T_FIBROBLAST	Bone giant_cell_tumour
HS822T_FIBROBLAST	Bone Ewings_sarcoma-peripheral_primitive_neuroectodermal_tumour
HS834T_FIBROBLAST	Skin malignant_melanoma
HS839T_FIBROBLAST	Skin malignant_melanoma
HS840T_FIBROBLAST	Upper_aerodigestive_tract other
HS852T_SKIN	Skin malignant_melanoma
HS863T_FIBROBLAST	Bone Ewings_sarcoma-peripheral_primitive_neuroectodermal_tumour
HS870T_FIBROBLAST	Bone osteosarcoma
HS888T_FIBROBLAST	Bone osteosarcoma
HS895T_FIBROBLAST	Skin malignant_melanoma
HS934T_FIBROBLAST	Skin malignant_melanoma
HS936T_SKIN	Skin malignant_melanoma
HS939T_SKIN	Skin malignant_melanoma
HS940T_FIBROBLAST	Skin malignant_melanoma
HS944T_SKIN	Skin malignant_melanoma
HSC2_UPPER_AERODIGESTIVE_TRACT	Upper_aerodigestive_tract carcinoma
HSC3_UPPER_AERODIGESTIVE_TRACT	Upper_aerodigestive_tract carcinoma
HSC4_UPPER_AERODIGESTIVE_TRACT	Upper_aerodigestive_tract carcinoma
HT1080_SOFT_TISSUE	Soft_tissue
HT115_LARGE_INTESTINE	Large_intestine carcinoma
HT1197_URINARY_TRACT	Urinary_tract carcinoma
HT1376_URINARY_TRACT	Urinary_tract carcinoma
HT144_SKIN	Skin malignant_melanoma
HT29_LARGE_INTESTINE	Large_intestine carcinoma
HT55_LARGE_INTESTINE	Large_intestine carcinoma
HT_HAEMATOPOIETIC_AND_LYMPHOID_TISSUE	Haematopoietic_and_lymphoid_tissue
HUCCT1_BILIARY_TRACT	Biliary_tract carcinoma
HUG1N_STOMACH	Stomach carcinoma
HUH1_LIVER	Liver carcinoma
HUH28_BILIARY_TRACT	Biliary_tract carcinoma
HUH6_LIVER	Liver other
HUH7_LIVER	Liver carcinoma
HUNS1_HAEMATOPOIETIC_AND_LYMPHOID_TISSUE	Haematopoietic_and_lymphoid_tissue
HUPT3_PANCREAS	Pancreas carcinoma
HUPT4_PANCREAS	Pancreas carcinoma
HUT102_HAEMATOPOIETIC_AND_LYMPHOID_TISSUE	Haematopoietic_and_lymphoid_tissue
HUT78_HAEMATOPOIETIC_AND_LYMPHOID_TISSUE	Haematopoietic_and_lymphoid_tissue
HUTU80_SMALL_INTESTINE	Small_intestine carcinoma
IALM_LUNG	Lung carcinoma
IGR1_SKIN	Skin malignant_melanoma
IGR37_SKIN	Skin malignant_melanoma
IGR39_SKIN	Skin malignant_melanoma
IGROV1_OVARY	Ovary carcinoma
IM95_STOMACH	Stomach carcinoma
IMR32_AUTONOMIC_GANGLIA	Autonomic_ganglia neuroblastoma
INA6_HAEMATOPOIETIC_AND_LYMPHOID_TISSUE	NA NA
IOMMLEE_CENTRAL_NERVOUS_SYSTEM	Central_nervous_system meningioma
IPC298_SKIN	Skin malignant_melanoma
ISHIKAWAHERAKLIO02ER_ENDOMETRIUM	Endometrium carcinoma
ISTMES1_PLEURA	Pleura mesothelioma
ISTMES2_PLEURA	Pleura mesothelioma
J82_URINARY_TRACT	Urinary_tract carcinoma
JEKO1_HAEMATOPOIETIC_AND_LYMPHOID_TISSUE	Haematopoietic_and_lymphoid_tissue
JHESOAD1_OESOPHAGUS	Oesophagus carcinoma
JHH1_LIVER	Liver carcinoma
JHH2_LIVER	Liver carcinoma
JHH4_LIVER	Liver carcinoma
JHH5_LIVER	Liver carcinoma
JHH6_LIVER	Liver carcinoma
JHH7_LIVER	Liver carcinoma
JHOC5_OVARY	Ovary carcinoma
JHOM1_OVARY	Ovary carcinoma
JHOM2B_OVARY	Ovary carcinoma
JHOS2_OVARY	Ovary carcinoma
JHOS4_OVARY	Ovary carcinoma
JHUEM1_ENDOMETRIUM	Endometrium carcinoma
JHUEM2_ENDOMETRIUM	Endometrium carcinoma
JHUEM3_ENDOMETRIUM	Endometrium carcinoma
JHUEM7_ENDOMETRIUM	Endometrium carcinoma
JIMT1_BREAST	Breast carcinoma
JJN3_HAEMATOPOIETIC_AND_LYMPHOID_TISSUE	Haematopoietic_and_lymphoid_tissue
JK1_HAEMATOPOIETIC_AND_LYMPHOID_TISSUE	Haematopoietic_and_lymphoid_tissue
JL1_PLEURA	Pleura mesothelioma
JM1_HAEMATOPOIETIC_AND_LYMPHOID_TISSUE	Haematopoietic_and_lymphoid_tissue
JMSU1_URINARY_TRACT	Urinary_tract carcinoma
JURKAT_HAEMATOPOIETIC_AND_LYMPHOID_TISSUE	Haematopoietic_and_lymphoid_tissue
JURLMK1_HAEMATOPOIETIC_AND_LYMPHOID_TISSUE	Haematopoietic_and_lymphoid_tissue
JVM2_HAEMATOPOIETIC_AND_LYMPHOID_TISSUE	Haematopoietic_and_lymphoid_tissue
JVM3_HAEMATOPOIETIC_AND_LYMPHOID_TISSUE	Haematopoietic_and_lymphoid_tissue
K029AX_SKIN	Skin malignant_melanoma
K562_HAEMATOPOIETIC_AND_LYMPHOID_TISSUE	Haematopoietic_and_lymphoid_tissue
KALS1_CENTRAL_NERVOUS_SYSTEM	Central_nervous_system glioma
KARPAS299_HAEMATOPOIETIC_AND_LYMPHOID_TISSUE	Haematopoietic_and_lymphoid_tissue
KARPAS422_HAEMATOPOIETIC_AND_LYMPHOID_TISSUE	Haematopoietic_and_lymphoid_tissue
KARPAS620_HAEMATOPOIETIC_AND_LYMPHOID_TISSUE	Haematopoietic_and_lymphoid_tissue
KASUMI1_HAEMATOPOIETIC_AND_LYMPHOID_TISSUE	Haematopoietic_and_lymphoid_tissue
KASUMI2_HAEMATOPOIETIC_AND_LYMPHOID_TISSUE	Haematopoietic_and_lymphoid_tissue
KASUMI6_HAEMATOPOIETIC_AND_LYMPHOID_TISSUE	Haematopoietic_and_lymphoid_tissue
KATOIII_STOMACH	Stomach carcinoma
KCL22_HAEMATOPOIETIC_AND_LYMPHOID_TISSUE	Haematopoietic_and_lymphoid_tissue
KD_SOFT_TISSUE	NA NA
KE37_HAEMATOPOIETIC_AND_LYMPHOID_TISSUE	Haematopoietic_and_lymphoid_tissue
KE39_STOMACH	Stomach carcinoma
KE97_HAEMATOPOIETIC_AND_LYMPHOID_TISSUE	Haematopoietic_and_lymphoid_tissue
KELLY_AUTONOMIC_GANGLIA	Autonomic_ganglia neuroblastoma
KG1C_CENTRAL_NERVOUS_SYSTEM	Central_nervous_system glioma
KG1_HAEMATOPOIETIC_AND_LYMPHOID_TISSUE	Haematopoietic_and_lymphoid_tissue
KHM1B_HAEMATOPOIETIC_AND_LYMPHOID_TISSUE	Haematopoietic_and_lymphoid_tissue
KIJK_HAEMATOPOIETIC_AND_LYMPHOID_TISSUE	Haematopoietic_and_lymphoid_tissue
KLE_ENDOMETRIUM	Endometrium carcinoma
KM12_LARGE_INTESTINE	Large_intestine carcinoma
KMBC2_URINARY_TRACT	Urinary_tract carcinoma
KMH2_HAEMATOPOIETIC_AND_LYMPHOID_TISSUE	Haematopoietic_and_lymphoid_tissue
KMM1_HAEMATOPOIETIC_AND_LYMPHOID_TISSUE	Haematopoietic_and_lymphoid_tissue
KMRC1_KIDNEY	Kidney carcinoma
KMRC20_KIDNEY	Kidney carcinoma
KMRC2_KIDNEY	Kidney carcinoma
KMRC3_KIDNEY	Kidney carcinoma
KMS11_HAEMATOPOIETIC_AND_LYMPHOID_TISSUE	Haematopoietic_and_lymphoid_tissue
KMS12BM_HAEMATOPOIETIC_AND_LYMPHOID_TISSUE	Haematopoietic_and_lymphoid_tissue
KMS18_HAEMATOPOIETIC_AND_LYMPHOID_TISSUE	Haematopoietic_and_lymphoid_tissue
KMS20_HAEMATOPOIETIC_AND_LYMPHOID_TISSUE	Haematopoietic_and_lymphoid_tissue
KMS21BM_HAEMATOPOIETIC_AND_LYMPHOID_TISSUE	Haematopoietic_and_lymphoid_tissue
KMS26_HAEMATOPOIETIC_AND_LYMPHOID_TISSUE	Haematopoietic_and_lymphoid_tissue
KMS27_HAEMATOPOIETIC_AND_LYMPHOID_TISSUE	Haematopoietic_and_lymphoid_tissue
KMS28BM_HAEMATOPOIETIC_AND_LYMPHOID_TISSUE	Haematopoietic_and_lymphoid_tissue
KMS34_HAEMATOPOIETIC_AND_LYMPHOID_TISSUE	Haematopoietic_and_lymphoid_tissue
KNS42_CENTRAL_NERVOUS_SYSTEM	Central_nervous_system glioma
KNS60_CENTRAL_NERVOUS_SYSTEM	Central_nervous_system glioma
KNS62_LUNG	Lung carcinoma
KNS81_CENTRAL_NERVOUS_SYSTEM	Central_nervous_system glioma
KO52_HAEMATOPOIETIC_AND_LYMPHOID_TISSUE	Haematopoietic_and_lymphoid_tissue
KOPN8_HAEMATOPOIETIC_AND_LYMPHOID_TISSUE	Haematopoietic_and_lymphoid_tissue
KP2_PANCREAS	Pancreas carcinoma
KP3_PANCREAS	Pancreas carcinoma
KP4_PANCREAS	Pancreas carcinoma
KPL1_BREAST	Breast carcinoma
KPMRTRY_SOFT_TISSUE	NA NA
KPNRTBM1_AUTONOMIC_GANGLIA	Autonomic_ganglia neuroblastoma
KPNSI9S_AUTONOMIC_GANGLIA	Autonomic_ganglia neuroblastoma
KPNYN_AUTONOMIC_GANGLIA	Autonomic_ganglia neuroblastoma
KS1_CENTRAL_NERVOUS_SYSTEM	Central_nervous_system glioma
KU1919_URINARY_TRACT	Urinary_tract carcinoma
KU812_HAEMATOPOIETIC_AND_LYMPHOID_TISSUE	Haematopoietic_and_lymphoid_tissue
KURAMOCHI_OVARY	Ovary carcinoma
KYM1_SOFT_TISSUE	Soft_tissue
KYO1_HAEMATOPOIETIC_AND_LYMPHOID_TISSUE	Haematopoietic_and_lymphoid_tissue
KYSE140_OESOPHAGUS	Oesophagus carcinoma
KYSE150_OESOPHAGUS	Oesophagus carcinoma
KYSE180_OESOPHAGUS	Oesophagus carcinoma
KYSE270_OESOPHAGUS	Oesophagus carcinoma
KYSE30_OESOPHAGUS	Oesophagus carcinoma
KYSE410_OESOPHAGUS	Oesophagus carcinoma
KYSE450_OESOPHAGUS	Oesophagus carcinoma
KYSE510_OESOPHAGUS	Oesophagus carcinoma
KYSE520_OESOPHAGUS	Oesophagus carcinoma
KYSE70_OESOPHAGUS	Oesophagus carcinoma
L1236_HAEMATOPOIETIC_AND_LYMPHOID_TISSUE	Haematopoietic_and_lymphoid_tissue
L33_PANCREAS	Pancreas carcinoma
L363_HAEMATOPOIETIC_AND_LYMPHOID_TISSUE	Haematopoietic_and_lymphoid_tissue
L428_HAEMATOPOIETIC_AND_LYMPHOID_TISSUE	Haematopoietic_and_lymphoid_tissue
L540_HAEMATOPOIETIC_AND_LYMPHOID_TISSUE	Haematopoietic_and_lymphoid_tissue
LAMA84_HAEMATOPOIETIC_AND_LYMPHOID_TISSUE	Haematopoietic_and_lymphoid_tissue
LC1F_LUNG	Lung carcinoma
LCLC103H_LUNG	Lung carcinoma
LCLC97TM1_LUNG	Lung carcinoma
LI7_LIVER	Liver carcinoma
LK2_LUNG	Lung carcinoma
LMSU_STOMACH	Stomach carcinoma
LN18_CENTRAL_NERVOUS_SYSTEM	Central_nervous_system glioma
LN215_CENTRAL_NERVOUS_SYSTEM	Central_nervous_system glioma
LN229_CENTRAL_NERVOUS_SYSTEM	Central_nervous_system glioma
LN235_CENTRAL_NERVOUS_SYSTEM	Central_nervous_system glioma
LN319_CENTRAL_NERVOUS_SYSTEM	Central_nervous_system glioma
LN340_CENTRAL_NERVOUS_SYSTEM	Central_nervous_system glioma
LN382_CENTRAL_NERVOUS_SYSTEM	Central_nervous_system glioma
LN428_CENTRAL_NERVOUS_SYSTEM	Central_nervous_system glioma
LN443_CENTRAL_NERVOUS_SYSTEM	Central_nervous_system glioma
LN464_CENTRAL_NERVOUS_SYSTEM	Central_nervous_system glioma
LNCAPCLONEFGC_PROSTATE	Prostate carcinoma
LNZ308_CENTRAL_NERVOUS_SYSTEM	Central_nervous_system glioma
LOUCY_HAEMATOPOIETIC_AND_LYMPHOID_TISSUE	Haematopoietic_and_lymphoid_tissue
LOUNH91_LUNG	Lung carcinoma
LOVO_LARGE_INTESTINE	Large_intestine carcinoma
LOXIMVI_SKIN	Skin malignant_melanoma
LP1_HAEMATOPOIETIC_AND_LYMPHOID_TISSUE	Haematopoietic_and_lymphoid_tissue
LS1034_LARGE_INTESTINE	Large_intestine carcinoma
LS123_LARGE_INTESTINE	Large_intestine carcinoma
LS180_LARGE_INTESTINE	Large_intestine carcinoma
LS411N_LARGE_INTESTINE	Large_intestine carcinoma
LS513_LARGE_INTESTINE	Large_intestine carcinoma
LU65_LUNG	Lung carcinoma
LU99_LUNG	Lung carcinoma
LUDLU1_LUNG	Lung carcinoma
LXF289_LUNG	Lung carcinoma
M059K_CENTRAL_NERVOUS_SYSTEM	Central_nervous_system glioma
M07E_HAEMATOPOIETIC_AND_LYMPHOID_TISSUE	Haematopoietic_and_lymphoid_tissue
MALME3M_SKIN	Skin malignant_melanoma
MC116_HAEMATOPOIETIC_AND_LYMPHOID_TISSUE	Haematopoietic_and_lymphoid_tissue
MCAS_OVARY	Ovary carcinoma
MCF7_BREAST	Breast carcinoma
MDAMB134VI_BREAST	Breast carcinoma
MDAMB157_BREAST	Breast carcinoma
MDAMB175VII_BREAST	Breast carcinoma
MDAMB231_BREAST	Breast carcinoma
MDAMB361_BREAST	Breast carcinoma
MDAMB415_BREAST	Breast carcinoma
MDAMB435S_SKIN	Skin malignant_melanoma
MDAMB436_BREAST	Breast carcinoma
MDAMB453_BREAST	Breast carcinoma
MDAMB468_BREAST	Breast carcinoma
MDAPCA2B_PROSTATE	Prostate carcinoma
MDST8_LARGE_INTESTINE	Large_intestine carcinoma
ME1_HAEMATOPOIETIC_AND_LYMPHOID_TISSUE	Haematopoietic_and_lymphoid_tissue
MEC1_HAEMATOPOIETIC_AND_LYMPHOID_TISSUE	Haematopoietic_and_lymphoid_tissue
MEG01_HAEMATOPOIETIC_AND_LYMPHOID_TISSUE	Haematopoietic_and_lymphoid_tissue
MELHO_SKIN	Skin malignant_melanoma
MELJUSO_SKIN	Skin malignant_melanoma
MESSA_SOFT_TISSUE	Soft_tissue
MEWO_SKIN	Skin malignant_melanoma
MFE280_ENDOMETRIUM	Endometrium carcinoma
MFE296_ENDOMETRIUM	Endometrium carcinoma
MFE319_ENDOMETRIUM	Endometrium carcinoma
MG63_BONE	Bone osteosarcoma
MHHCALL2_HAEMATOPOIETIC_AND_LYMPHOID_TISSUE	Haematopoietic_and_lymphoid_tissue
MHHCALL3_HAEMATOPOIETIC_AND_LYMPHOID_TISSUE	Haematopoietic_and_lymphoid_tissue
MHHCALL4_HAEMATOPOIETIC_AND_LYMPHOID_TISSUE	Haematopoietic_and_lymphoid_tissue
MHHES1_BONE	Bone Ewings_sarcoma-peripheral_primitive_neuroectodermal_tumour
MHHNB11_AUTONOMIC_GANGLIA	Autonomic_ganglia neuroblastoma
MIAPACA2_PANCREAS	Pancreas carcinoma
MINO_HAEMATOPOIETIC_AND_LYMPHOID_TISSUE	Haematopoietic_and_lymphoid_tissue
MJ_HAEMATOPOIETIC_AND_LYMPHOID_TISSUE	Haematopoietic_and_lymphoid_tissue
MKN1_STOMACH	Stomach carcinoma
MKN45_STOMACH	Stomach carcinoma
MKN74_STOMACH	Stomach carcinoma
MKN7_STOMACH	Stomach carcinoma
ML1_THYROID	Thyroid carcinoma
MM1S_HAEMATOPOIETIC_AND_LYMPHOID_TISSUE	Haematopoietic_and_lymphoid_tissue
MOLM13_HAEMATOPOIETIC_AND_LYMPHOID_TISSUE	Haematopoietic_and_lymphoid_tissue
MOLM16_HAEMATOPOIETIC_AND_LYMPHOID_TISSUE	Haematopoietic_and_lymphoid_tissue
MOLM6_HAEMATOPOIETIC_AND_LYMPHOID_TISSUE	Haematopoietic_and_lymphoid_tissue
MOLP2_HAEMATOPOIETIC_AND_LYMPHOID_TISSUE	Haematopoietic_and_lymphoid_tissue
MOLP8_HAEMATOPOIETIC_AND_LYMPHOID_TISSUE	Haematopoietic_and_lymphoid_tissue
MOLT13_HAEMATOPOIETIC_AND_LYMPHOID_TISSUE	Haematopoietic_and_lymphoid_tissue
MOLT16_HAEMATOPOIETIC_AND_LYMPHOID_TISSUE	Haematopoietic_and_lymphoid_tissue
MOLT3_HAEMATOPOIETIC_AND_LYMPHOID_TISSUE	Haematopoietic_and_lymphoid_tissue
MONOMAC1_HAEMATOPOIETIC_AND_LYMPHOID_TISSUE	Haematopoietic_and_lymphoid_tissue
MONOMAC6_HAEMATOPOIETIC_AND_LYMPHOID_TISSUE	Haematopoietic_and_lymphoid_tissue
MON_SOFT_TISSUE	NA NA
MORCPR_LUNG	Lung carcinoma
MPP89_PLEURA	Pleura mesothelioma
MSTO211H_PLEURA	Pleura mesothelioma
MUTZ3_HAEMATOPOIETIC_AND_LYMPHOID_TISSUE	Haematopoietic_and_lymphoid_tissue
MUTZ5_HAEMATOPOIETIC_AND_LYMPHOID_TISSUE	Haematopoietic_and_lymphoid_tissue
MV411_HAEMATOPOIETIC_AND_LYMPHOID_TISSUE	Haematopoietic_and_lymphoid_tissue
NALM19_HAEMATOPOIETIC_AND_LYMPHOID_TISSUE	Haematopoietic_and_lymphoid_tissue
NALM1_HAEMATOPOIETIC_AND_LYMPHOID_TISSUE	Haematopoietic_and_lymphoid_tissue
NALM6_HAEMATOPOIETIC_AND_LYMPHOID_TISSUE	Haematopoietic_and_lymphoid_tissue
NAMALWA_HAEMATOPOIETIC_AND_LYMPHOID_TISSUE	Haematopoietic_and_lymphoid_tissue
NB1_AUTONOMIC_GANGLIA	Autonomic_ganglia neuroblastoma
NB4_HAEMATOPOIETIC_AND_LYMPHOID_TISSUE	Haematopoietic_and_lymphoid_tissue
NCCSTCK140_STOMACH	Stomach carcinoma
NCIH1048_LUNG	Lung carcinoma
NCIH1092_LUNG	Lung carcinoma
NCIH1105_LUNG	Lung carcinoma
NCIH1155_LUNG	Lung carcinoma
NCIH1184_LUNG	Lung carcinoma
NCIH1299_LUNG	Lung carcinoma
NCIH1339_LUNG	Lung carcinoma
NCIH1341_LUNG	Lung carcinoma
NCIH1355_LUNG	Lung carcinoma
NCIH1373_LUNG	Lung carcinoma
NCIH1385_LUNG	Lung carcinoma
NCIH1395_LUNG	Lung carcinoma
NCIH1435_LUNG	Lung carcinoma
NCIH1436_LUNG	Lung carcinoma
NCIH1437_LUNG	Lung carcinoma
NCIH146_LUNG	Lung carcinoma
NCIH1563_LUNG	Lung carcinoma
NCIH1568_LUNG	Lung carcinoma
NCIH1573_LUNG	Lung carcinoma
NCIH1581_LUNG	Lung carcinoma
NCIH1618_LUNG	Lung carcinoma
NCIH1623_LUNG	Lung carcinoma
NCIH1648_LUNG	Lung carcinoma
NCIH1650_LUNG	Lung carcinoma
NCIH1651_LUNG	Lung carcinoma
NCIH1666_LUNG	Lung carcinoma
NCIH1693_LUNG	Lung carcinoma
NCIH1694_LUNG	Lung carcinoma
NCIH1703_LUNG	Lung carcinoma
NCIH1734_LUNG	Lung carcinoma
NCIH1755_LUNG	Lung carcinoma
NCIH1781_LUNG	Lung carcinoma
NCIH1792_LUNG	Lung carcinoma
NCIH1793_LUNG	Lung carcinoma
NCIH1819_LUNG	NA NA
NCIH1836_LUNG	Lung carcinoma
NCIH1838_LUNG	Lung carcinoma
NCIH1869_LUNG	Lung carcinoma
NCIH1876_LUNG	Lung carcinoma
NCIH1915_LUNG	Lung carcinoma
NCIH1930_LUNG	Lung carcinoma
NCIH1944_LUNG	Lung carcinoma
NCIH1963_LUNG	Lung carcinoma
NCIH196_LUNG	Lung carcinoma
NCIH1975_LUNG	Lung carcinoma
NCIH2004RT_SOFT_TISSUE	NA NA
NCIH2009_LUNG	Lung carcinoma
NCIH2023_LUNG	Lung carcinoma
NCIH2029_LUNG	Lung carcinoma
NCIH2030_LUNG	Lung carcinoma
NCIH2052_PLEURA	Pleura mesothelioma
NCIH2066_LUNG	Lung carcinoma
NCIH2073_LUNG	Lung carcinoma
NCIH2077_LUNG	NA NA
NCIH2081_LUNG	Lung carcinoma
NCIH2085_LUNG	Lung carcinoma
NCIH2087_LUNG	Lung carcinoma
NCIH209_LUNG	Lung carcinoma
NCIH2106_LUNG	Lung carcinoma
NCIH2110_LUNG	Lung carcinoma
NCIH211_LUNG	Lung carcinoma
NCIH2122_LUNG	Lung carcinoma
NCIH2126_LUNG	Lung carcinoma
NCIH2170_LUNG	Lung carcinoma
NCIH2171_LUNG	Lung carcinoma
NCIH2172_LUNG	Lung carcinoma
NCIH2196_LUNG	Lung carcinoma
NCIH2227_LUNG	Lung carcinoma
NCIH2228_LUNG	Lung carcinoma
NCIH226_LUNG	Lung carcinoma
NCIH2286_LUNG	Lung carcinoma
NCIH2291_LUNG	Lung carcinoma
NCIH2342_LUNG	Lung carcinoma
NCIH2347_LUNG	Lung carcinoma
NCIH23_LUNG	Lung carcinoma
NCIH2405_LUNG	Lung carcinoma
NCIH2444_LUNG	Lung carcinoma
NCIH2452_PLEURA	Pleura mesothelioma
NCIH2882_LUNG	NA NA
NCIH2887_LUNG	NA NA
NCIH28_PLEURA	Pleura mesothelioma
NCIH292_LUNG	Lung carcinoma
NCIH3122_LUNG	NA NA
NCIH322_LUNG	Lung carcinoma
NCIH3255_LUNG	Lung carcinoma
NCIH358_LUNG	Lung carcinoma
NCIH441_LUNG	Lung carcinoma
NCIH446_LUNG	Lung carcinoma
NCIH460_LUNG	Lung carcinoma
NCIH508_LARGE_INTESTINE	Large_intestine carcinoma
NCIH510_LUNG	Lung carcinoma
NCIH520_LUNG	Lung carcinoma
NCIH522_LUNG	Lung carcinoma
NCIH524_LUNG	Lung carcinoma
NCIH526_LUNG	Lung carcinoma
NCIH596_LUNG	Lung carcinoma
NCIH647_LUNG	Lung carcinoma
NCIH650_LUNG	Lung carcinoma
NCIH660_PROSTATE	Prostate carcinoma
NCIH661_LUNG	Lung carcinoma
NCIH684_LIVER	Liver other
NCIH69_LUNG	Lung carcinoma
NCIH716_LARGE_INTESTINE	Large_intestine carcinoma
NCIH727_LUNG	Lung carcinoid-endocrine_tumour
NCIH747_LARGE_INTESTINE	Large_intestine carcinoma
NCIH810_LUNG	Lung carcinoma
NCIH82_LUNG	Lung carcinoma
NCIH838_LUNG	Lung carcinoma
NCIH841_LUNG	Lung carcinoma
NCIH854_LUNG	Lung carcinoma
NCIH889_LUNG	Lung carcinoma
NCIH929_HAEMATOPOIETIC_AND_LYMPHOID_TISSUE	Haematopoietic_and_lymphoid_tissue
NCIN87_STOMACH	Stomach carcinoma
NCO2_HAEMATOPOIETIC_AND_LYMPHOID_TISSUE	Haematopoietic_and_lymphoid_tissue
NH6_AUTONOMIC_GANGLIA	Autonomic_ganglia neuroblastoma
NHAHTDD_CENTRAL_NERVOUS_SYSTEM	NA NA
NIHOVCAR3_OVARY	Ovary carcinoma
NMCG1_CENTRAL_NERVOUS_SYSTEM	Central_nervous_system glioma
NOMO1_HAEMATOPOIETIC_AND_LYMPHOID_TISSUE	Haematopoietic_and_lymphoid_tissue
NUDHL1_HAEMATOPOIETIC_AND_LYMPHOID_TISSUE	Haematopoietic_and_lymphoid_tissue
NUDUL1_HAEMATOPOIETIC_AND_LYMPHOID_TISSUE	Haematopoietic_and_lymphoid_tissue
NUGC2_STOMACH	Stomach carcinoma
NUGC3_STOMACH	Stomach carcinoma
NUGC4_STOMACH	Stomach carcinoma
OAW28_OVARY	Ovary carcinoma
OAW42_OVARY	Ovary carcinoma
OC314_OVARY	Ovary carcinoma
OCIAML2_HAEMATOPOIETIC_AND_LYMPHOID_TISSUE	Haematopoietic_and_lymphoid_tissue
OCIAML3_HAEMATOPOIETIC_AND_LYMPHOID_TISSUE	Haematopoietic_and_lymphoid_tissue
OCIAML5_HAEMATOPOIETIC_AND_LYMPHOID_TISSUE	Haematopoietic_and_lymphoid_tissue
OCILY19_HAEMATOPOIETIC_AND_LYMPHOID_TISSUE	Haematopoietic_and_lymphoid_tissue
OCILY3_HAEMATOPOIETIC_AND_LYMPHOID_TISSUE	Haematopoietic_and_lymphoid_tissue
OCIM1_HAEMATOPOIETIC_AND_LYMPHOID_TISSUE	Haematopoietic_and_lymphoid_tissue
OCIMY5_HAEMATOPOIETIC_AND_LYMPHOID_TISSUE	NA NA
OCIMY7_HAEMATOPOIETIC_AND_LYMPHOID_TISSUE	NA NA
OCUM1_STOMACH	Stomach carcinoma
OE19_OESOPHAGUS	Oesophagus carcinoma
OE21_OESOPHAGUS	Oesophagus carcinoma
OE33_OESOPHAGUS	Oesophagus other
OELE_OVARY	Ovary other
ONCODG1_OVARY	Ovary carcinoma
ONS76_CENTRAL_NERVOUS_SYSTEM	Central_nervous_system primitive_neuroectodermal_tumour-medulloblastoma
OPM1_HAEMATOPOIETIC_AND_LYMPHOID_TISSUE	NA NA
OPM2_HAEMATOPOIETIC_AND_LYMPHOID_TISSUE	Haematopoietic_and_lymphoid_tissue
OSRC2_KIDNEY	Kidney carcinoma
OUMS23_LARGE_INTESTINE	Large_intestine carcinoma
OV56_OVARY	Ovary carcinoma
OV7_OVARY	Ovary carcinoma
OV90_OVARY	Ovary carcinoma
OVCAR4_OVARY	Ovary carcinoma
OVCAR8_OVARY	Ovary carcinoma
OVISE_OVARY	Ovary carcinoma
OVK18_OVARY	Ovary carcinoma
OVKATE_OVARY	Ovary carcinoma
OVMANA_OVARY	Ovary carcinoma
OVSAHO_OVARY	Ovary carcinoma
OVTOKO_OVARY	Ovary carcinoma
P12ICHIKAWA_HAEMATOPOIETIC_AND_LYMPHOID_TISSUE	Haematopoietic_and_lymphoid_tissue
P31FUJ_HAEMATOPOIETIC_AND_LYMPHOID_TISSUE	Haematopoietic_and_lymphoid_tissue
P3HR1_HAEMATOPOIETIC_AND_LYMPHOID_TISSUE	Haematopoietic_and_lymphoid_tissue
PANC0203_PANCREAS	Pancreas carcinoma
PANC0213_PANCREAS	Pancreas carcinoma
PANC0327_PANCREAS	Pancreas carcinoma
PANC0403_PANCREAS	Pancreas carcinoma
PANC0504_PANCREAS	Pancreas carcinoma
PANC0813_PANCREAS	Pancreas carcinoma
PANC1005_PANCREAS	Pancreas carcinoma
PANC1_PANCREAS	Pancreas carcinoma
PATU8902_PANCREAS	Pancreas carcinoma
PATU8988S_PANCREAS	Pancreas carcinoma
PATU8988T_PANCREAS	Pancreas carcinoma
PC14_LUNG	Lung carcinoma
PC3_PROSTATE	Prostate carcinoma
PC9_LUNG	NA NA
PECAPJ15_UPPER_AERODIGESTIVE_TRACT	Upper_aerodigestive_tract carcinoma
PECAPJ34CLONEC12_UPPER_AERODIGESTIVE_TRACT	Upper_aerodigestive_tract carcinoma
PECAPJ41CLONED2_UPPER_AERODIGESTIVE_TRACT	Upper_aerodigestive_tract carcinoma
PECAPJ49_UPPER_AERODIGESTIVE_TRACT	Upper_aerodigestive_tract carcinoma
PEER_HAEMATOPOIETIC_AND_LYMPHOID_TISSUE	Haematopoietic_and_lymphoid_tissue
PF382_HAEMATOPOIETIC_AND_LYMPHOID_TISSUE	Haematopoietic_and_lymphoid_tissue
PFEIFFER_HAEMATOPOIETIC_AND_LYMPHOID_TISSUE	Haematopoietic_and_lymphoid_tissue
PK1_PANCREAS	Pancreas carcinoma
PK45H_PANCREAS	Pancreas carcinoma
PK59_PANCREAS	Pancreas carcinoma
PL21_HAEMATOPOIETIC_AND_LYMPHOID_TISSUE	Haematopoietic_and_lymphoid_tissue
PLB985_HAEMATOPOIETIC_AND_LYMPHOID_TISSUE	Haematopoietic_and_lymphoid_tissue
PLCPRF5_LIVER	Liver carcinoma
PRECLH_PROSTATE	Prostate other
PSN1_PANCREAS	Pancreas carcinoma
QGP1_PANCREAS	Pancreas carcinoma
RAJI_HAEMATOPOIETIC_AND_LYMPHOID_TISSUE	Haematopoietic_and_lymphoid_tissue
RCC10RGB_KIDNEY	Kidney carcinoma
RCHACV_HAEMATOPOIETIC_AND_LYMPHOID_TISSUE	Haematopoietic_and_lymphoid_tissue
RCM1_LARGE_INTESTINE	Large_intestine carcinoma
RDES_BONE	Bone Ewings_sarcoma-peripheral_primitive_neuroectodermal_tumour
RD_SOFT_TISSUE	Soft_tissue
REC1_HAEMATOPOIETIC_AND_LYMPHOID_TISSUE	Haematopoietic_and_lymphoid_tissue
REH_HAEMATOPOIETIC_AND_LYMPHOID_TISSUE	Haematopoietic_and_lymphoid_tissue
RERFGC1B_STOMACH	Stomach carcinoma
RERFLCAD1_LUNG	Lung carcinoma
RERFLCAD2_LUNG	Lung carcinoma
RERFLCAI_LUNG	Lung carcinoma
RERFLCKJ_LUNG	Lung carcinoma
RERFLCMS_LUNG	Lung carcinoma
RERFLCSQ1_LUNG	Lung carcinoma
RH18_SOFT_TISSUE	Soft_tissue
RH30_SOFT_TISSUE	Soft_tissue
RH41_SOFT_TISSUE	Soft_tissue
RI1_HAEMATOPOIETIC_AND_LYMPHOID_TISSUE	Haematopoietic_and_lymphoid_tissue
RKN_SOFT_TISSUE	Soft_tissue
RKO_LARGE_INTESTINE	Large_intestine carcinoma
RL952_ENDOMETRIUM	Endometrium carcinoma
RL_HAEMATOPOIETIC_AND_LYMPHOID_TISSUE	Haematopoietic_and_lymphoid_tissue
RMGI_OVARY	Ovary carcinoma
RMUGS_OVARY	Ovary carcinoma
RPMI7951_SKIN	Skin malignant_melanoma
RPMI8226_HAEMATOPOIETIC_AND_LYMPHOID_TISSUE	Haematopoietic_and_lymphoid_tissue
RPMI8402_HAEMATOPOIETIC_AND_LYMPHOID_TISSUE	Haematopoietic_and_lymphoid_tissue
RS411_HAEMATOPOIETIC_AND_LYMPHOID_TISSUE	Haematopoietic_and_lymphoid_tissue
RS5_FIBROBLAST	Pleura mesothelioma
RT112_URINARY_TRACT	Urinary_tract carcinoma
RT4_URINARY_TRACT	Urinary_tract carcinoma
RVH421_SKIN	Skin malignant_melanoma
S117_THYROID	Soft_tissue
SALE_LUNG	Lung other
SAOS2_BONE	Bone osteosarcoma
SBC5_LUNG	Lung carcinoma
SCABER_URINARY_TRACT	Urinary_tract carcinoma
SCC15_UPPER_AERODIGESTIVE_TRACT	Upper_aerodigestive_tract carcinoma
SCC25_UPPER_AERODIGESTIVE_TRACT	Upper_aerodigestive_tract carcinoma
SCC4_UPPER_AERODIGESTIVE_TRACT	Upper_aerodigestive_tract carcinoma
SCC9_UPPER_AERODIGESTIVE_TRACT	Upper_aerodigestive_tract carcinoma
SCLC21H_LUNG	Lung carcinoma
SEM_HAEMATOPOIETIC_AND_LYMPHOID_TISSUE	Haematopoietic_and_lymphoid_tissue
SET2_HAEMATOPOIETIC_AND_LYMPHOID_TISSUE	Haematopoietic_and_lymphoid_tissue
SF126_CENTRAL_NERVOUS_SYSTEM	Central_nervous_system glioma
SF172_CENTRAL_NERVOUS_SYSTEM	Central_nervous_system glioma
SF268_CENTRAL_NERVOUS_SYSTEM	Central_nervous_system glioma
SF295_CENTRAL_NERVOUS_SYSTEM	Central_nervous_system glioma
SF539_CENTRAL_NERVOUS_SYSTEM	Central_nervous_system glioma
SF767_CERVIX	Central_nervous_system glioma
SH10TC_STOMACH	Stomach carcinoma
SH4_SKIN	Skin malignant_melanoma
SHP77_LUNG	Lung carcinoma
SIGM5_HAEMATOPOIETIC_AND_LYMPHOID_TISSUE	Haematopoietic_and_lymphoid_tissue
SIHA_CERVIX	NA NA
SIMA_AUTONOMIC_GANGLIA	Autonomic_ganglia neuroblastoma
SJSA1_BONE	Bone osteosarcoma
SKBR3_BREAST	Breast carcinoma
SKCO1_LARGE_INTESTINE	Large_intestine carcinoma
SKES1_BONE	Bone Ewings_sarcoma-peripheral_primitive_neuroectodermal_tumour
SKHEP1_LIVER	Liver carcinoma
SKLMS1_SOFT_TISSUE	Soft_tissue
SKLU1_LUNG	Lung carcinoma
SKM1_HAEMATOPOIETIC_AND_LYMPHOID_TISSUE	Haematopoietic_and_lymphoid_tissue
SKMEL1_SKIN	Skin malignant_melanoma
SKMEL24_SKIN	Skin malignant_melanoma
SKMEL28_SKIN	Skin malignant_melanoma
SKMEL30_SKIN	Skin malignant_melanoma
SKMEL31_SKIN	Skin malignant_melanoma
SKMEL3_SKIN	Skin malignant_melanoma
SKMEL5_SKIN	Skin malignant_melanoma
SKMES1_LUNG	Lung carcinoma
SKMM2_HAEMATOPOIETIC_AND_LYMPHOID_TISSUE	Haematopoietic_and_lymphoid_tissue
SKNAS_AUTONOMIC_GANGLIA	Autonomic_ganglia neuroblastoma
SKNBE2_AUTONOMIC_GANGLIA	Autonomic_ganglia neuroblastoma
SKNDZ_AUTONOMIC_GANGLIA	Autonomic_ganglia neuroblastoma
SKNEP1_BONE	NA NA
SKNFI_AUTONOMIC_GANGLIA	Autonomic_ganglia neuroblastoma
SKNMC_BONE	Bone Ewings_sarcoma-peripheral_primitive_neuroectodermal_tumour
SKNO1_HAEMATOPOIETIC_AND_LYMPHOID_TISSUE	Haematopoietic_and_lymphoid_tissue
SKNSH_AUTONOMIC_GANGLIA	Autonomic_ganglia neuroblastoma
SKOV3_OVARY	Ovary carcinoma
SKPNDW_BONE	NA NA
SKRC20_KIDNEY	Kidney carcinoma
SKUT1_SOFT_TISSUE	Soft_tissue
SLR20_KIDNEY	Kidney carcinoma
SLR21_KIDNEY	Kidney carcinoma
SLR23_KIDNEY	Kidney carcinoma
SLR24_KIDNEY	Kidney carcinoma
SLR25_KIDNEY	Kidney carcinoma
SLR26_KIDNEY	Kidney carcinoma
SNB75_CENTRAL_NERVOUS_SYSTEM	Central_nervous_system glioma
SNGM_ENDOMETRIUM	Endometrium carcinoma
SNU1033_LARGE_INTESTINE	Large_intestine carcinoma
SNU1040_LARGE_INTESTINE	Large_intestine carcinoma
SNU1041_UPPER_AERODIGESTIVE_TRACT	Upper_aerodigestive_tract carcinoma
SNU1066_UPPER_AERODIGESTIVE_TRACT	Upper_aerodigestive_tract carcinoma
SNU1076_UPPER_AERODIGESTIVE_TRACT	Upper_aerodigestive_tract carcinoma
SNU1077_ENDOMETRIUM	Endometrium carcinoma
SNU1079_BILIARY_TRACT	Biliary_tract carcinoma
SNU1105_CENTRAL_NERVOUS_SYSTEM	Central_nervous_system glioma
SNU1196_BILIARY_TRACT	Biliary_tract carcinoma
SNU1197_LARGE_INTESTINE	Large_intestine carcinoma
SNU119_OVARY	Ovary carcinoma
SNU1214_UPPER_AERODIGESTIVE_TRACT	Upper_aerodigestive_tract carcinoma
SNU1272_KIDNEY	Kidney carcinoma
SNU16_STOMACH	Stomach carcinoma
SNU175_LARGE_INTESTINE	Large_intestine carcinoma
SNU182_LIVER	Liver carcinoma
SNU1_STOMACH	Stomach carcinoma
SNU201_CENTRAL_NERVOUS_SYSTEM	Central_nervous_system glioma
SNU213_PANCREAS	Pancreas carcinoma
SNU216_STOMACH	Stomach carcinoma
SNU245_BILIARY_TRACT	Biliary_tract carcinoma
SNU283_LARGE_INTESTINE	Large_intestine carcinoma
SNU308_BILIARY_TRACT	Biliary_tract carcinoma
SNU324_PANCREAS	Pancreas carcinoma
SNU349_KIDNEY	Kidney carcinoma
SNU387_LIVER	Liver carcinoma
SNU398_LIVER	Liver carcinoma
SNU407_LARGE_INTESTINE	Large_intestine carcinoma
SNU410_PANCREAS	Pancreas carcinoma
SNU423_LIVER	Liver carcinoma
SNU449_LIVER	Liver carcinoma
SNU466_CENTRAL_NERVOUS_SYSTEM	Central_nervous_system glioma
SNU46_UPPER_AERODIGESTIVE_TRACT	Upper_aerodigestive_tract carcinoma
SNU475_LIVER	Liver carcinoma
SNU478_BILIARY_TRACT	Biliary_tract carcinoma
SNU489_CENTRAL_NERVOUS_SYSTEM	Central_nervous_system glioma
SNU503_LARGE_INTESTINE	Large_intestine carcinoma
SNU520_STOMACH	Stomach carcinoma
SNU5_STOMACH	Stomach carcinoma
SNU601_STOMACH	Stomach carcinoma
SNU61_LARGE_INTESTINE	Large_intestine carcinoma
SNU620_STOMACH	Stomach carcinoma
SNU626_CENTRAL_NERVOUS_SYSTEM	Central_nervous_system glioma
SNU668_STOMACH	Stomach carcinoma
SNU685_ENDOMETRIUM	Endometrium carcinoma
SNU719_STOMACH	Stomach carcinoma
SNU738_CENTRAL_NERVOUS_SYSTEM	Central_nervous_system glioma
SNU761_LIVER	Liver carcinoma
SNU81_LARGE_INTESTINE	Large_intestine carcinoma
SNU840_OVARY	Ovary carcinoma
SNU869_BILIARY_TRACT	Biliary_tract carcinoma
SNU878_LIVER	Liver carcinoma
SNU886_LIVER	Liver carcinoma
SNU899_UPPER_AERODIGESTIVE_TRACT	Upper_aerodigestive_tract carcinoma
SNU8_OVARY	Ovary carcinoma
SNUC1_LARGE_INTESTINE	Large_intestine carcinoma
SNUC2A_LARGE_INTESTINE	Large_intestine carcinoma
SNUC4_LARGE_INTESTINE	Large_intestine carcinoma
SNUC5_LARGE_INTESTINE	Large_intestine carcinoma
SQ1_LUNG	Lung carcinoma
SR786_HAEMATOPOIETIC_AND_LYMPHOID_TISSUE	Haematopoietic_and_lymphoid_tissue
ST486_HAEMATOPOIETIC_AND_LYMPHOID_TISSUE	Haematopoietic_and_lymphoid_tissue
STM9101_SOFT_TISSUE	NA NA
SU8686_PANCREAS	Pancreas carcinoma
SUDHL10_HAEMATOPOIETIC_AND_LYMPHOID_TISSUE	Haematopoietic_and_lymphoid_tissue
SUDHL1_HAEMATOPOIETIC_AND_LYMPHOID_TISSUE	Haematopoietic_and_lymphoid_tissue
SUDHL4_HAEMATOPOIETIC_AND_LYMPHOID_TISSUE	Haematopoietic_and_lymphoid_tissue
SUDHL5_HAEMATOPOIETIC_AND_LYMPHOID_TISSUE	Haematopoietic_and_lymphoid_tissue
SUDHL6_HAEMATOPOIETIC_AND_LYMPHOID_TISSUE	Haematopoietic_and_lymphoid_tissue
SUDHL8_HAEMATOPOIETIC_AND_LYMPHOID_TISSUE	Haematopoietic_and_lymphoid_tissue
SUIT2_PANCREAS	Pancreas carcinoma
SUPB15_HAEMATOPOIETIC_AND_LYMPHOID_TISSUE	Haematopoietic_and_lymphoid_tissue
SUPM2_HAEMATOPOIETIC_AND_LYMPHOID_TISSUE	Haematopoietic_and_lymphoid_tissue
SUPT11_HAEMATOPOIETIC_AND_LYMPHOID_TISSUE	Haematopoietic_and_lymphoid_tissue
SUPT1_HAEMATOPOIETIC_AND_LYMPHOID_TISSUE	Haematopoietic_and_lymphoid_tissue
SW1088_CENTRAL_NERVOUS_SYSTEM	Central_nervous_system glioma
SW1116_LARGE_INTESTINE	Large_intestine carcinoma
SW1271_LUNG	Lung carcinoma
SW1353_BONE	Bone chondrosarcoma
SW1417_LARGE_INTESTINE	Large_intestine carcinoma
SW1463_LARGE_INTESTINE	Large_intestine carcinoma
SW1573_LUNG	Lung carcinoma
SW1710_URINARY_TRACT	Urinary_tract carcinoma
SW1783_CENTRAL_NERVOUS_SYSTEM	Central_nervous_system glioma
SW1990_PANCREAS	Pancreas carcinoma
SW403_LARGE_INTESTINE	Large_intestine carcinoma
SW480_LARGE_INTESTINE	Large_intestine carcinoma
SW48_LARGE_INTESTINE	Large_intestine carcinoma
SW579_THYROID	Thyroid carcinoma
SW620_LARGE_INTESTINE	Large_intestine carcinoma
SW780_URINARY_TRACT	Urinary_tract carcinoma
SW837_LARGE_INTESTINE	Large_intestine carcinoma
SW900_LUNG	Lung carcinoma
SW948_LARGE_INTESTINE	Large_intestine carcinoma
T173_FIBROBLAST	Bone osteosarcoma
T24_URINARY_TRACT	Urinary_tract carcinoma
T3M10_LUNG	Lung carcinoma
T3M4_PANCREAS	Pancreas carcinoma
T47D_BREAST	Breast carcinoma
T84_LARGE_INTESTINE	Large_intestine carcinoma
T98G_CENTRAL_NERVOUS_SYSTEM	Central_nervous_system glioma
TALL1_HAEMATOPOIETIC_AND_LYMPHOID_TISSUE	Haematopoietic_and_lymphoid_tissue
TC71_BONE	Bone Ewings_sarcoma-peripheral_primitive_neuroectodermal_tumour
TCCPAN2_PANCREAS	Pancreas carcinoma
TCCSUP_URINARY_TRACT	Urinary_tract carcinoma
TE10_OESOPHAGUS	Oesophagus carcinoma
TE11_OESOPHAGUS	Oesophagus carcinoma
TE125T_FIBROBLAST	Soft_tissue
TE14_OESOPHAGUS	Oesophagus carcinoma
TE159T_FIBROBLAST	Soft_tissue
TE15_OESOPHAGUS	Oesophagus carcinoma
TE1_OESOPHAGUS	Oesophagus carcinoma
TE441T_SOFT_TISSUE	Soft_tissue
TE4_OESOPHAGUS	Oesophagus carcinoma
TE5_OESOPHAGUS	Oesophagus carcinoma
TE617T_SOFT_TISSUE	Soft_tissue
TE6_OESOPHAGUS	Oesophagus carcinoma
TE8_OESOPHAGUS	Oesophagus carcinoma
TE9_OESOPHAGUS	Oesophagus carcinoma
TEN_ENDOMETRIUM	Endometrium carcinoma
TF1_HAEMATOPOIETIC_AND_LYMPHOID_TISSUE	Haematopoietic_and_lymphoid_tissue
TGBC11TKB_STOMACH	Stomach carcinoma
THP1_HAEMATOPOIETIC_AND_LYMPHOID_TISSUE	Haematopoietic_and_lymphoid_tissue
TIG3TD_FIBROBLAST	Lung other
TM31_CENTRAL_NERVOUS_SYSTEM	Central_nervous_system glioma
TM87_SOFT_TISSUE	NA NA
TO175T_FIBROBLAST	Haematopoietic_and_lymphoid_tissue
TOLEDO_HAEMATOPOIETIC_AND_LYMPHOID_TISSUE	Haematopoietic_and_lymphoid_tissue
TOV112D_OVARY	Ovary carcinoma
TOV21G_OVARY	Ovary carcinoma
TT2609C02_THYROID	Thyroid carcinoma
TTC1240_SOFT_TISSUE	NA NA
TTC549_SOFT_TISSUE	NA NA
TTC642_SOFT_TISSUE	NA NA
TTC709_SOFT_TISSUE	NA NA
TT_OESOPHAGUS	NA NA
TT_THYROID	Thyroid carcinoma
TUHR10TKB_KIDNEY	Kidney carcinoma
TUHR14TKB_KIDNEY	Kidney carcinoma
TUHR4TKB_KIDNEY	Kidney carcinoma
TYKNU_OVARY	Ovary carcinoma
U118MG_CENTRAL_NERVOUS_SYSTEM	Central_nervous_system glioma
U178_CENTRAL_NERVOUS_SYSTEM	Central_nervous_system glioma
U251MG_CENTRAL_NERVOUS_SYSTEM	Central_nervous_system glioma
U266B1_HAEMATOPOIETIC_AND_LYMPHOID_TISSUE	Haematopoietic_and_lymphoid_tissue
U2OS_BONE	Bone osteosarcoma
U343_CENTRAL_NERVOUS_SYSTEM	Central_nervous_system glioma
U87MG_CENTRAL_NERVOUS_SYSTEM	Central_nervous_system glioma
U937_HAEMATOPOIETIC_AND_LYMPHOID_TISSUE	Haematopoietic_and_lymphoid_tissue
UACC257_SKIN	Skin malignant_melanoma
UACC62_SKIN	Skin malignant_melanoma
UACC812_BREAST	Breast carcinoma
UACC893_BREAST	Breast carcinoma
UBLC1_URINARY_TRACT	Urinary_tract carcinoma
UMUC1_URINARY_TRACT	Urinary_tract carcinoma
UMUC3_URINARY_TRACT	Urinary_tract carcinoma
UO31_KIDNEY	Kidney carcinoma
UOK101_KIDNEY	Kidney carcinoma
VCAP_PROSTATE	Prostate carcinoma
VMCUB1_URINARY_TRACT	Urinary_tract carcinoma
VMRCRCW_KIDNEY	Kidney carcinoma
VMRCRCZ_KIDNEY	Kidney carcinoma
WM115_SKIN	Skin malignant_melanoma
WM1799_SKIN	Skin malignant_melanoma
WM2664_SKIN	Skin malignant_melanoma
WM793_SKIN	Skin malignant_melanoma
WM88_SKIN	Skin malignant_melanoma
WM983B_SKIN	Skin malignant_melanoma
WSUDLCL2_HAEMATOPOIETIC_AND_LYMPHOID_TISSUE	Haematopoietic_and_lymphoid_tissue
YAPC_PANCREAS	Pancreas carcinoma
YD10B_UPPER_AERODIGESTIVE_TRACT	Upper_aerodigestive_tract carcinoma
YD15_SALIVARY_GLAND	Salivary_gland carcinoma
YD38_UPPER_AERODIGESTIVE_TRACT	Upper_aerodigestive_tract carcinoma
YD8_UPPER_AERODIGESTIVE_TRACT	Upper_aerodigestive_tract carcinoma
YH13_CENTRAL_NERVOUS_SYSTEM	Central_nervous_system glioma
YKG1_CENTRAL_NERVOUS_SYSTEM	Central_nervous_system glioma
ZR751_BREAST	Breast carcinoma
ZR7530_BREAST	Breast carcinoma
